/* ===================================== */
/* Copyright 2017, Hoogspanningsnet.com  */
/* Script by BaDu                        */
/*                                       */
/* This file contains the german trans-  */
/* lation of the netkaart                */
/* Version : 31-03-2017                  */
/* ===================================== */
Aantal velden=Feld anzahl
Eenfase=Einfase
Tweefasen=Zweifasen
Driefasen=Dreifasen
Afkorting=Abkürzung
Afspanmast=Abspannmast
Aftakmast=Abzweigmast
anders/onbekend=anderes/unbekannt
Asymmetrisch enkelcircuitmast=Asymmetrische Einzelkreismast
B2B converter=Asynchron umwandler
Bedankt voor uw feedback we gaan er zo snel mogelijk mee aan de slag=Danke fur ihre feedback, wir bearbeiten es so schnell wie möglich
Dank dat u wil helpen met het verbeteren van onze netkaart, vul alstublieft het formulier in=Danke das sie uns helfen wollen unsere netzkarte zu verbesseren, bitte füllen sie das formular unten
Mochten wij naar aanleiding van uw bericht nog vragen hebben, dan nemen we contact met u op=Sollten wir noch fragen über ihre feedback haben, dan hören sie von uns
Bedr.spanning=Betr.spannung
Bedrijfscentrum=Betriebszentrum
Bedrijfsmiddel=Betriebsmittel
Bedrijfsspanning=Betriebsspannung
Beheerder=Betreiber
Beheerder primair=Betreiber primär
Beheerder secundair=Betreiber secundär
Beheerdercode=Betreibercode
Beheerdernaam=Betreibername
Beheerdernummer=Betreibernummer
Benutting=Benutzung
Betonnen mast=Betonmast
Bipole=Bipol
Bipoolmast=Bipolmast
Bouwwijze=Bauweise
Bouwjaar onbekend=Baujahr unbekannt
Bron(nen)= Quelle(n)
Buismast=Rohrmast
Bug/Update=Fehler/Update
Capaciteit=Capazität
Circuits=Linien
Code=Code
Colofon=Impressum (nl)
Combinatiemast=Kombinationsmast
Communicatietoren=Communicationsturm
Compensatiespoel=Compenstionsspühle
Condensatorbank=Condensatoranlage
Condensatorveld=Condensatorfeld
Constructiewijze=Construction
Controle getal=Controlnummer
Converter=Umrichter
Copyrights=Uhrheberrechte
Bipool=Bipol
Monopool aardretour=Monopol erdrückfluss
Monopool geleiderretour=Monopol Leiterrückfluss
Symmetrische monopool=Monopol symmetrisch
Deelnet=Teilnetz
Deltamast=Deltamast
Dennenboommast=Tannenbaummast
Disclaimer=Haftungsausschluss (nl)
Donaumast=Donaumast
Driefasen=Dreifasen
Driehoeksmast=Dreieckmast
Drierail=Dreischiene
Drievlaksmast=Drei-Ebene-Mast
Dubbelrail=Doppelschiene
Dubbelrail U-I=Doppelschiene U-I
Dubbelrail met bypassrail=Doppelschiene mit Umlaufschiene
Dubbelvlagmast=Doppelflaggemast
Eengeleidermast=Einzelleitermast
Eindmast=Endmast
Elektrodepunt=Elektrodenpunkt
Enkelrail=Einzel schiene
Enkelrail - langskoppeling=Einzelschiene - langskupplung
Er moet een Gebruikersnaam en Wachtwoord worden ingevuld=Sie müsssen Gebrauchername und Kennwort eingeben
Er kan op dit moment geen verbinding gemaakt worden met de netkaart-database, probeer het over 20 seconden normaals=In diesem moment können wir keine verbinding darstellen mit der Netzkarte-database, versuchen sie es in 20 secunden mal wieder
Fase-nul=Fase-null
Feedback netkaart=Feedback netzkarte
Feedback formulier=Feedback formular
Feedback melden=Feedback melden
Feedback geregistreerd op Github=Feedback würde registriert auf Github
Foto URL=Bild URL
FOUT: Geen data gevonden=FEHLER: Kein data gefunden
FOUT: geen valide input=FEHLER: Daten nicht OK
Fout melden=Fehler melden
Foute query=Falscher query
Frequentie-omvormer=Frequenzumrichter
Functie=Function
Gaffelmast=Gaffelmast
Gasgeïsoleerd=Gas insuliert
Gebruiker login=Gebraucher anmelden
Gebruikersnaam=Gebrauchername
Gebruikersnaam/Wachtwoord ongeldig=Gebrauchername/Kennwort ungültig
Gecombineerde situatie=Combinierte abzweig
Geen AC of DC=Kein AC oder DC
GEEN FOTO BESCHIKBAAR=KEIN BILD VERFÜGBAR
Geen correct gegevens type=Kein correctes datatyp
Geen geldig circuit ID=Kein gültiger linien ID
Geen geldige afbeelding URL= Kein gültiger bild URL
Geen integer=Kein integer
Geen jaar tussen 0 en 9999=Kein jahr zwischen 0 und 9999
Geen wijzigingen=Kein änderungen
Geen zoekresultaat=Kein suchergebnis
Gelijkspanning=Gleichspannung
Generatorveld=Generatorfeld
GIS=GIS
Grond=Grund
Grondkabel=Landkabel
Hamerkopmast=Hammerkopfmast
Handleiding=Anleitung (nl)
Hangende rails=Schienen hängend
Harde aftak=Hartes abzweig
heden=heute
hier=hier
Hoekmast=Eckmast
HoogspanningsNet Netkaart=HoogspanningsNet Netzkarte
Hoogspanningskabel=Hochspannungskabel
Hoogspanningslijn=Hochspannungslinie
Hoogspanningsmast=Hochspannungsmast
Hoogspanningsstation=Hochspannungsstation
Hoogste spanning=Höchste spannung
Hoogte=Höhe
Houten mast=Holzmast
Hybride geïsoleerd=Hybrid insuliert
Hybridemast=Hybridmast
ID=ID
ID niet gevonden=ID nicht gefunden
In dienst=In betrieb
ingevuld bij=eingefült bei
Inloggen=Anmelden
Inloggen om te bewerken=Anmelden für bearbeiten
Inlussing=Abzweig schleife
Instellingen=Einstellungen
Instellingen opslaan=Einstellungen speichern
Instellingen opgeslagen=Einstellungen gespeichert
Instellingen verbergen=Einstellungen verbergen
Instellingen weergeven=Einstellungen wiedergeben
item=item
Item bijgewerkt=Item geändert
Item niet bijgewerkt, waarden waren niet gewijzigd=Item nicht geändert, werte waren niet geändert
Kabel=Kabel
kabel=kabel
Kabelveld=Kabelfeld
Kies=Wähle
Klantstation=Kundenwerk
Klik om deze gegevens te bewerken=Klick hier um diese daten zu bearbeiten
Knooppunten=Knotenpunkte
Koppelstation=Kupelstation
Koppelveld=Kuppelfeld
Koppeltrafoveld=Kuppeltransformatorfeld
Koppeltransformatorveld=Kuppeltransformatorfeld
Land=Land
Layers opslaan=Layers speichern
Legenda=Legende
Legenda verbergen=Legende verbergen 
Legenda weergeven=Legende wiedergeben
Lengte=Länge
Lijn=Linie
Lijnveld=Linienfeld
Luchtgeïsoleerd=Luft insuliert
Luchtlijn=Freileitung
Masten=Masten
Mastfunctie=Mastzweck
Masthoogte=Masthöhe
Mastmodel=Mastmodell
Mastnummer=Mastnummer
Meld een fout of aanvullende informatie over dit object=Melde ein fehler oder zusatzlichte informationen über dieses objekt
Model=Modell
Monopool aardretour=Monopol erd rückfluss
Monopool geleiderretour=Monopol leiter rückfluss
Naam=Name
naam=name
Naar mijn huidige locatie!=Zu mein standort!
Netfrequentie=Netzfrequenz
Net knooppunt=Netz knotenpunkt
Netkaart instellingen=Netzkarte Einstellungen
Netsituatie=Knotentyp
Objecttype=Objecttyp
onbekend=unbekannt
Onderwerp=Betreff
Ongeldige landcode=Ungultiger Ländercode
Onjuist format=Falscher format
Ontw.spanning=Entw.spannung
Ontwerpspanning=Entwurfspannung
Opmerkingen=Bemerkungen
Opstijgpunt=Steigpunkt
overig (zie opmerkingen)=übrich (ziehe bemerkungen)
overig=sonstige
Overig=Sonstige
Overkruisingsmast=Kreuzungsmast
Over de netkaart=Über die netzkarte
Overkruising=Überkreuzung
Pas uw criteria aan=Ändern sie ihre suchcriterien
Portaalmast=Portalmast
Productie=Erzeugung
Railcapaciteit=Schienen capacität
Railconfiguratie=Schienen configuration
Release notes=Release-Infos (nl)
Ringrail=Ring schiene
RNB-Trafoveld=RNB-Transformatorfeld
RNB-Transformatorveld=RNB-Transformatorfeld
Schakelbare aftak=Schaltbare abzweig
Schakelstation=Schaltwerk
Schoormast=Abgespannter mast
Secundair=Secundär
Spanning=Spannung
Spanningen=Spannungen
Spanningsloos=Spannungslos
Splitsing=Gabelung
Splitsingsmast=Splitsingsmast
Spoelveld=Spuhlefeld
Staande rails=Schienen stehend
Stationsiconen=Piktogramme
Stationsterreinen=Grundstücke
Steunmast=Tragmast
Stijgjuk=Steigportal
Subtype=Untertyp
Supergeleidend=Supraleitend
Symmetrical monopole=Monopol symmetrisch
Systeem=System
Taal voorkeur=Sprache einstellung
Taal=Sprache
TF-apparatuur=Tönfrequentanlage
Tonmast=Tonnenmast
Transformator=Transformator
Trafostation=Umspannwerk
Transformatorveld=Transformatorfeld
Transportcapaciteit=Transportcapacität
Tweefasen=Zweifasen
Tweevlaksmast=Zwei-Ebene-Mast
Type=Typ
U bent binnen=Sie sind innerhalb
U kunt de voortgang=Sie können den vorschub
Uit dienst=Aus betrieb
Uw naam=Ihre name
Uw email=Ihre email
Uw feedback=Ihre feedback
Vakwerkmast=Gittermast
van dit punt=diesem punkt
Verbinding=Verbindung
Verbindingen=Verbindungen
Versie=Version
Verzend feedback=Feedback senden
Verzenden=Senden
Viervlaksmast=Vier-Ebene-Mast
View opslaan=View speichern
Vlagmast=Flaggemast
Volg locatie=Folge standort
volgen=folgen
Wachtwoord=Kennwort
Wijzingen=Änderungen
Wisselmast=Verdrillmast
Wisselspanning=Wechelspannung
Wissen=Wischen
Zee=Meeres
Zoek...=Suche...
Zoeken!=Suchen!
Zoeken in de netkaart=Suchen in die netzkarte
Naar de website=Zum website
Nederlands=Niederländisch
Nedersaksisch=Niedersächsisch
Deens=Dänisch
Duits=Deutsch
Engels=Englisch
Frans=Französisch
Nederland=Niederlande
België=Belgien
Duitsland=Deutschland
Franrijk=Frankreich
Groot Britannië=Großbritannien
Denemarken=Dänemark
Zwitserland=Die Schweiz
Oostenrijk=Österreich
Spanje=Spanien
Italië=Italien
Polen=Polen
Zweden=Schweden
Noorwegen=Norwegen
