/* ===================================== */
/* Copyright 2017, Hoogspanningsnet.com  */
/* Script by BaDu                        */
/*                                       */
/* This file contains the danish trans-  */
/* lation of the netkaart                */
/* Translation by forumuser HaDu         */
/* Version : 02-08-2017                  */
/* ===================================== */
Aantal velden=Ental felter 
Eenfase=Enkeltfase
Tweefasen=Tofaser
Driefasen=Trefaser
Afkorting=Forkortelse
Afspanmast=Afspændingsmast
Aftakmast=Afgreningsmast
anders/onbekend=andet/ukendt
Asymmetrisch enkelcircuitmast=Asymmetrisk énsystem mast
B2B converter=B2B konverter
Bedankt voor uw feedback we gaan er zo snel mogelijk mee aan de slag=Tak for din feedback vi vil bearbejde den snarest muligt
Dank dat u wil helpen met het verbeteren van onze netkaart, vul alstublieft het formulier in=Tak fordi du vil hjælpe med at forbedre vores netkort, udfyldt venligst formularen
Mochten wij naar aanleiding van uw bericht nog vragen hebben, dan nemen we contact met u op=Hvis vi har spørgsmål om din feedback vil vi kontakte dig
Bedr.spanning=Driftspænding
Bedrijfscentrum=Anlægscenter
Bedrijfsmiddel=Driftsmiddel
Bedrijfsspanning=Driftspænding
Beheerder=Elselskab
Beheerder primair=Primært selskab
Beheerder secundair=Sekundært selskab
Beheerdercode=Selskabskode
Beheerdernaam=Selskabsnavn
Beheerdernummer=Selskabsnummer
Benutting=Brug
Betonnen mast=Betonmast
Bipole=Topælemast
Bipoolmast=Topælemast
Bouwwijze=Konstruktion
Bouwjaar onbekend=Byggeår ukendt
Bron(nen)=Kilde(r)
Buismast=Rørmast
Bug/Update=Bug/Opdatering
Capaciteit=Kapacitet
Circuit(s)=Strømkreds(e)
Code=Kode
Colofon=Kolofon
Combinatiemast=Kombimast
Communicatietoren=Kommunikationstårn
Compensatiespoel=Kompensationsspole
Condensatorbank=Kondensatorbatteri
Condensatorveld=Kondensatorfelt
Constructiewijze=Konstruktion
Controle getal=Kontroltal
Converter=Konverter
Copyrights=Copyright
Bipool=Dobbeltpol
Monopool aardretour=Enkeltpol jord retur
Monopool geleiderretour=Enkeltpol ledning retur
Symmetrische monopool=Symmetrisk enkeltpol
Deelnet=Netdel
Deltamast=Y-mast
Dennenboommast=Fyrtræmast
Disclaimer=Ansvarsfraskrivelse
Donaumast=Donaumast
Driehoeksmast=Trekantsmast
Drierail=Tripelskinne
Drievlaksmast=Tre etagers mast
Dubbelrail=Dobbeltskinne
Dubbelrail - U-I=Dobbeltskinne U-I-konstruktion
Dubbelrail - bypassrail=Bypassdobbeltskinne
Dubbelvlagmast=To sidemast
Eengeleidermast=Enkeltledermast
Eindmast=Endemast
Elektrodepunt=Elektrode
Enkelrail=Enkeltskinne
Enkelrail - langskoppeling=Enkeltskinne med længdekobling
Er moet een Gebruikersnaam en Wachtwoord worden ingevuld=Der skal udfyldes brugernavn og adgangskode
Er kan op dit moment geen verbinding gemaakt worden met de netkaart-database. Probeer het over 20 seconden normaals=Lige nu er der ikke forbindelse med netkaart-databasen, prøv igen om 20 sekunder
Fase-nul=Nul leder
Feedback netkaart=Feedback til Netkortet
Feedback formulier=Feedback formular
Feedback geregistreerd op Github=Mange tak! Din feedback er registreret på GitHub.
Feedback melden=Sende feedback
Foto URL=Foto URL
FOUT: Geen data gevonden=FEJL: Ingen data fundt.
FOUT: geen valide input=FEJL: Forkert input
Fout melden=Meld en fejl
Foute query=Forkert søge kriterium
Frequentie-omvormer=Frekvensomformer
Functie=Funktion
Gaffelmast=Gaffelmast
Gasgeïsoleerd=Gasisoleret
Gebruiker login=Brugeradgang
Gebruikersnaam=Brugernavn
Gebruikersnaam/Wachtwoord ongeldig=Brugernavn eller adgangskode ugyldigt
Gecombineerde situatie=Kombineret situation
Geen AC of DC=Hverken AC eller DC
GEEN FOTO BESCHIKBAAR=&nbsp;&nbsp;&nbsp;&nbsp;&nbsp;&nbsp;&nbsp;INGEN BILLEDET
Geen correct gegevens type=Forkert data type
Geen geldig circuit ID=Ukendt circuit
Geen geldige afbeelding URL=Ikke en billedside
Geen integer=Ikke et heltal
Geen jaar tussen 0 en 9999=Årstallet ikke mellem 0 og 9999
Geen wijzigingen=Ingen forandringen
Geen zoekresultaat=Søgning uden resultat
Gelijkspanning=Jævnspænding
Generatorveld=Generator felt
GIS=GIS-anlæg
Grond=Jord
Grondkabel=Jordkabel
Hamerkopmast=Hammerhovedmast
Handleiding=Brugsanvisning
Hangende rails=Hængende skinner
Harde aftak=Fest afgrening
heden=i dag
hier=her 
Hoekmast=Knækpunktmast
HoogspanningsNet Netkaart=HoogspanningsNet Netkort
Hoogspanningskabel=Højspændingskabel 
Hoogspanningslijn=Luftledning
Hoogspanningsmast=Højspændingsmast
Hoogspanningsstation=Højspændingsstation
Hoogste spanning=Spidsspænding
Hoogte=Højde
Houten mast=Træmast
Hybride geïsoleerd=Hybrid isoleret
Hybridemast=Hybridmast
ID=ID
ID niet gevonden=ID ukendt
In dienst=I drift
ingevuld bij=opfyldt med
Inloggen=Logge på
Inloggen om te bewerken=Logge på for at bearbejde
Inlussing=Tilslutning
Instellingen=Indstillinger
Instellingen opslaan=Gemme indstillingerne
Instellingen opgeslagen=Indstillingerne gemt
Instellingen verbergen=At gemme indstillingerne
Instellingen weergeven=At vise indstillingerne
item=item
Item bijgewerkt=Item opdateret
Item niet bijgewerkt, waarden waren niet gewijzigd=Item ikke opdateret, værdier uforandret
Kabel=Kabel
kabel=kabel
Kabelveld=Kabelfelt
Kies=Valg
Klantstation=Kundestation
Klik om deze gegevens te bewerken=Klik her for at bearbejde
Knooppunten=Knudepunkter
Koppelstation=Koblingsstation
Koppelveld=Koblingsfelt
Land=Land
Layers opslaan=Gem layers
Legenda=Symbolforklaring
Legenda verbergen=Gem signaturforklaring
Legenda weergeven=Vis signaturforklaring
Lengte=Længde
Lijn=Luftledning
Lijnveld=Ledningsfelt
Luchtgeïsoleerd=Luftisoleret
Luchtlijn=Luftledning
Masten=Master
Mastfunctie=Mastfunktion
Masthoogte=Masthøjde
Mastmodel=Mastmodel
Mastnummer=Mastnummer
Meld een fout of aanvullende informatie over dit object=Meld venligst en fejl, eller giv ny information om objektet.
Model=Model
Monopool aardretour=Enkeltpol med jordretur
Monopool geleiderretour=Enkeltpol med ledningsretur
Naam=Navn
naam=navn
Naar mijn huidige locatie!=Vis min nuværende position!
Netfrequentie=Netfrekvens
Net knooppunt=Netknudepunkt
Netkaart instellingen=Netkort indstillingerne
Netsituatie=Nettilstand
Objecttype=Objekttype
onbekend=ukendt
Onderwerp=Emne
Ongeldige landcode=Landkode ugyldig
Onjuist format=Format ugyldig
Ontw.spanning=Des.spænding
Ontwerpspanning=Designspænding
Opmerkingen= Bemerkninger
Opstijgpunt=Opføringspunkt
overig (zie opmerkingen)=andet (se bemerkninger)
overig=øvrig
Overig=Øvrig
Overkruisingsmast=Krydsningsmast
Over de netkaart=Om Netkortet
Overkruising=Krydsning
Pas uw criteria aan=Forander venligst dine søgekriterier
Portaalmast=Portalmast
Productie=Produktion
Railcapaciteit=Skinne kapacitet
Railconfiguratie=Skinne konfiguration
Release notes=Versionshistorie
Ringrail=Ringskinne
Schakelbare aftak=Omskiftelig afgrening
Schakelstation=Omskiftestation
Schoormast=Bardunmast
Secundair=Sekundær
Spanning=Spænding
Spanningen=Spændinger
Spanningsloos=Spændingsløs
Splitsing=Splittelse
Splitsingsmast=Splittemast
Spoelveld=Spolefelt
Staande rails=Stående skinner
Stationsiconen=Stationssymboler
Stationsterreinen=Stationsareal
Steunmast=Bæremast
Stijgjuk=Opføringspunkt
Subtype=Subtype
Supergeleidend=Superledend
Symmetrisch monopol=Symmetrisk enkeltpol
Systeem=System
Taal voorkeur=Sprog præference
Taal=Sprog
TF-apparatuur=Akustisk styreanlæg
Tonmast=Tøndemast
Transformator=Transformer
Trafostation=Transformerstation
Transformatorveld=Transformerfelt
Transportcapaciteit=Transportkapacitet
Tweevlaksmast=Toetagersmast
Type=Type
U bent binnen=Du er indenfor
U kunt de voortgang=Du kan tracere dit billet
Uit dienst=Ude af drift
Uw naam=Dit navn
Uw email=Din email
Uw feedback=Din feedback
Vakwerkmast=Gittermast
van dit punt=herfra
Verbinding=Forbinding
Verbindingen=Forbindinger
Versie=Version
Verzend feedback=Send feedback
Verzenden=Sende
Viervlaksmast=4etagersmast
View opslaan=Gem viewet
Vlagmast=Enkelsidemast
Volg locatie=Følg  min  position
volgen=følge
Wachtwoord=Adgangskode
Wijzigingen=Forandringer
Wisselmast=Vekselmast
Wisselspanning=Vekselspænding
Wissen=Slette
Zee=Sø
Zeekabel=Søkabel
Zoek...=Søg...
Zoeken!=Søger!
Zoeken in de netkaart=Søger på Netkortet"
Naar de website=Til vores webside"
Nederlands=Hollandsk
Nedersaksisch=Nedersaksisk
Deens=Dansk
Duits=Tysk
Engels=Engelsk
Frans=Fransk"
Nederland=Holland
België=Belgien
Duitsland=Tyskland
Franrijk=Frankrig
Groot Britannië=Storbritannien
Denemarken=Danmark
Zwitserland=Schweiz
Oostenrijk=Østrig
Spanje=Spanien
Italië=Italien
Polen=Polen
Zweden=Sverige
Noorwegen=Norge
