/* ===================================== */
/* Copyright 2017, Hoogspanningsnet.com  */
/* Script by BaDu, translation by HansNien            */
/*                                       */
/* This file contains the niedersaksisch trans-  */
/* lation (nds SONT-schriefwieze) of the netkaart                */
/* Version : 31-03-2017                  */
/* ===================================== */
Aantal velden=Ansluutplekken
Eenfase=Ien fase
Tweefasen=Tweei fasen
Driefasen=Drie fasen
Afkorting=Kört
Afspanmast=Buustermast
Aftakmast=Anhakemast
anders/onbekend=oes vrömd
Asymmetrisch enkelcircuitmast=Ongale mast veur ien stroomkring
B2B converter=Doeido umzetter
Bedankt voor uw feedback we gaan er zo snel mogelijk mee aan de slag=Krek veur mekaor We bunt je merakel dankbaor veur je anwiezings en we maokt er rap wark van
Dank dat u wil helpen met het verbeteren van onze netkaart, vul alstublieft het formulier in=We bunt je schier dankbaor da'j oes toespringt A'j het formulier invult ku'j oes wieder helpen
Mochten wij naar aanleiding van uw bericht nog vragen hebben, dan nemen we contact met u op=As we 't slim stoer hebt met je schriefsel, dan heur'j herum van oes
Bedr.spanning=Warkspanning
Bedrijfscentrum=Bedriefsstee
Bedrijfsmiddel=Bedriefsunderdiel
Bedrijfsspanning=Warkspanning
Beheerder=Iegender
Beheerder primair=Eerste iegender
Beheerder secundair=Tweeide iegender
Beheerdercode=Iegendercode
Beheerdernaam=Naom van de iegender
Beheerdernummer=Iegendernummer
Benutting=Gebruuk
Betonnen mast=Betonpaol
Bipole=Vansgeliek
Bipoolmast=Vansgeliekenmast
Bouwwijze=Bouwwieze
Bouwjaar onbekend=Bouwjaar oes vrömd
Bron(nen)=Opduukelplekke
Buismast=Reurepaol
Bug/Update=Muute/Neiigheid
Capaciteit=Vermeugen
Circuits=Stroomkringen
Code=Code
Colofon=Wel 't daon hef (nl)
Combinatiemast=Tegaarbouwde mast
Communicatietoren=Radiotoren
Compensatiespoel=Compensatiewaol
Condensatorbank=Condensators
Condensatorveld=Condensatoransluuting
Constructiewijze=Hoe is 't bouwd
Controle getal=Naolöpgetal
Converter=Áanderaor
Copyrights=Liekerecht
Bipool=Tweei polen
Monopool aardretour=Ien pool, grond herum
Monopool geleiderretour=Ien pool en scheuperdroad herum
Symmetrische monopool=Eender warkende monopool
Deelnet=Undernet
Deltamast=Kat
Dennenboommast=Naaldboommast
Disclaimer=Vriewaoring (nl, e)
Donaumast=Donaumast
Driefasen=Driefasen
Driehoeksmast=Ongale mast
Drierail=Drierail
Drievlaksmast=Drievlak liekopmast
Dubbelrail=Tweeirail
Dubbelrail - U-I=Tweeirail - U-I 
Dubbelrail - bypassrail=Tweeirail met ofsnie
Dubbelvlagmast=Drievlak liekopmast
Eengeleidermast=Mast met ien draod
Eindmast=Éendmast
Elektrodepunt=Elektrodetip
Enkelrail=Ien rail
Enkelrail - langskoppeling=Ien rail - koppel in 't endelings
Er moet een Gebruikersnaam en Wachtwoord worden ingevuld=D'r is 'n Gebruukersnaom en Wachtwoord neudig
Er kan op dit moment geen verbinding gemaakt worden met de netkaart-database, probeer het over 20 seconden normaals='t Spiet oes meraokel, maor we kriegt gien sjoechem van de database. Waog 't temee weeran in een umzien
Fase-nul=Fase-nul
Feedback netkaart=Komsaozies netkaort
Feedback formulier=Formelier veur komsaozies
Feedback melden=Komsaozies angieven
Feedback geregistreerd op Github=Op Github ku'j oflezen hoe 't wieder giet
Foto URL=Petret URL
FOUT: Geen data gevonden=KRANG: gien data veurhanden
FOUT: geen valide input=KRANG: invoer giet nargens over
Fout melden=Vertel oes dat d'r worens helderop wat mis giet
Foute query=Query is krang
Frequentie-omvormer=Frequentie-umzetter
Functie=Taok
Gaffelmast=Vörkmast
Gasgeïsoleerd=Ofscharmd met gas
Gebruiker login=Gebruuker Login
Gebruikersnaam=Gebruukersnaom
Gebruikersnaam/Wachtwoord ongeldig=Naom of Wachtwoord he'j mis
Gecombineerde situatie=Tegaarbouwd of mandielig vermikkien
Geen AC of DC=Gien geliekstroom of wisselstroom
GEEN FOTO BESCHIKBAAR=GIEN PETRET VEURHANDEN
Geen correct gegevens type=Je schriefsel slaot niet an
Geen geldig circuit ID=Gien juust ID veur dizze stroomkring
Geen geldige afbeelding URL=Petret URL krang of niet naor de richtlienden
Geen integer=Gien bruukbaore wéerde
Geen jaar tussen 0 en 9999=Gien jaor maank 0 en 9999
Geen wijzigingen=Gien áanderings
Geen zoekresultaat=Gien zuukuutkomst
Gelijkspanning=Geliekspanning
Generatorveld=Generatoransluuting
GIS=GIS
Grond=Grond
Grondkabel=Grondkabel
Hamerkopmast=Hamerkop
Handleiding=Gebruuksbeschrieving
Hangende rails=Umhangende rails
Hanstaal=Henstaol
Harde aftak=Anhake
heden=dizze dag
hier=hier
Hoekmast=Zwenkepaol
HoogspanningsNet Netkaart=HoogspanningsNet Netkaort
Hoogspanningskabel=Hoogspanningskabel
Hoogspanningslijn=Hoogspanningslien
Hoogspanningsmast=Hoogspanningsmast
Hoogspanningsstation=Understation
Hoogste spanning=Hoogste spanning
Hoogte=Hoogte
Houten mast=Holtmast
Hybride geïsoleerd=Twieërlei ofscharmd
Hybridemast=Twieërlei mast
ID=ID
ID niet gevonden=ID niet opduukeld
In dienst=In gebruuk
ingevuld bij=Invuld bij
Inloggen=Anmelden
Inloggen om te bewerken=Meld je an om aanpassings uut te voeren
Inlussing=Oethaal
Instellingen=Instellings
Instellingen opslaan=Bewaor instellings
Instellingen opgeslagen=Instellings bent bewaord
Instellingen verbergen=Instellings uut zicht
Instellingen weergeven=Laot instellings zien
item=ding
Item bijgewerkt=Ding is anpast!
Item niet bijgewerkt, waarden waren niet gewijzigd=Ding is niet anpast, d'r was niets áanderd
Kabel=Kabel
Kabelveld=Kabelansluuting
Kies=Kies
Klantstation=Gebruukerstation
Klik om deze gegevens te bewerken=Klik om dizze gegevens te áandern
Knooppunten=Knupplek
Koppelstation=Koppelstation
Koppelveld=Koppelansluuting
Land=Laand
Layers opslaan=Bewaor lagen
Legenda=Verklaoring
Legenda verbergen=Verklaoring uut zicht
Legenda weergeven=Laot verklaoring zien
Lengte=Ofstand
Lijn=Lien
Lijnveld=Lienansluuting
Luchtgeïsoleerd=Geïsoleerd deur wind
Luchtlijn=Hoogspanningslien
Masten=Masten
Mastfunctie=Masttaok
Masthoogte=Masthoogte
Mastmodel=Mastanzicht
Mastnummer=Mastnummer
Meld een fout of aanvullende informatie over dit object=Zeg oes dat d'r wat niet riemt of stuur neie informatie
Model=Anzicht
Monopool aardretour=Ien pool met herum deur de grond
Monopool geleiderretour=Ien pool met herum deur een andere draod
Naam=Naom
naam=naom
Naar mijn huidige locatie!=Naor mien stee!
Netfrequentie=Netfrequentie
Net knooppunt=Netknuppe
Netkaart instellingen=Netkaort instellings
Netsituatie=Wa'j antreft
Objecttype=Soort ding
onbekend=vrömd
Onderwerp=Underwarp
Ongeldige landcode=Gien juuste landcode
Onjuist format=Gien juuste vörm
Ontw.spanning=Ontw.spanning
Ontwerpspanning=Ontwarpspanning
Opmerkingen=Bemarkings
Opstijgpunt=Opstiegplaots
overig (zie opmerkingen)=Áander (kiek op Bemarkings)
overig=áander
Overig=Áander
Overkruisingsmast=Kruzingsmast
Over de netkaart=Over dizze netkaort
Overkruising=Kruzing
Pas uw criteria aan=Schrief je zuukopdracht áans
Portaalmast=Juk
Productie=Opwek
Railcapaciteit=Railcapaciteit
Railconfiguratie=Railvörm
Release notes=Bemarkings
Ringrail=Herumlopende rail
Schakelbare aftak=Anhale met ofschaokel
Schakelstation=Schaokelstation
Schoormast=Tuimast
Secundair=Secundair
Spanning=Spanning
Spanningen=Spannings
Spanningsloos=Buuten gebruuk
Splitsing=Tweel
Splitsingsmast=Tweelmast
Spoelveld=Wikkelingsansluuting
Staande rails=Ophiesterde rails
Stationsiconen=Stationsbredties
Stationsterreinen=Stationshof
Steunmast=Reddepaol
Stijgjuk=Stiegjuk
Subtype=Slagvörm
Supergeleidend=Supergeleidend
Symmetrical monopole=Geliekopbruukte monopool
Systeem=Warking
Taal voorkeur=Taol die je anstiet
Taal=Taol of sproak
TF-apparatuur=TF-apperaot
Tonmast=Tunmast
Transformator=Trafo
Trafostation=Trafostation
Transformatorveld=Trafo-ansluuting
Transportcapaciteit=Transportcapaciteit
Tweefasen=Tweei fasen
Tweevlaksmast=Tweeivlaksmast
Type=Slag
U bent binnen=Je bunt in
U kunt de voortgang=Je kunt de vörderings
Uit dienst=Uut gebruuk
Uw naam=Naom
Uw email=Email
Uw feedback=Je komsaozies
Vakwerkmast=Lattenmast
van dit punt=van hier vört
Verbinding=Verbinding
Verbindingen=Verbindings
Versie=Uutvoering
Verzend feedback=Stuur komsaozies
Verzenden=Ofzenden
Viervlaksmast=Viervlaksmast
View opslaan=Bewaor uutzicht
Vlagmast=Drievlak liekopmast
Volg locatie=Volg waor ik hengao
volgen=volgen
Wachtwoord=Wachtwoord
Wijzingen=Áanderings
Wisselmast=Umhangmast
Wisselspanning=Wisselspanning
Wissen=Oetvegen
Zee=Zoltwater
Zoek...=Zuken..
Zoeken!=Zuuk
Zoeken in de netkaart=Duukel op in de netkaort
Naar de website=Naor oeze webstee
Nederlands=Nederlands
Nedersaksisch=Niedersaksisch
Deens=Deens
Duits=Duuts
Engels=Engels
Frans=Fraans
Nederland=Nederland
België=België
Duitsland=Duutsland
Franrijk=Fraankriek
Groot Britannië=Engelaand
Denemarken=Denemarken
Zwitserland=Zwitserlaand
Oostenrijk=Oostenriek
Spanje=Spanje
Italië=Italië
Polen=Polen
Zweden=Sweden
Noorwegen=Noorwegen
