/* ===================================== */
/* Copyright 2017, Hoogspanningsnet.com  */
/* Script by BaDu, translation by HansNien            */
/*                                       */
/* This file contains the english trans-  */
/* lation of the netkaart                */
/* Version : 31-03-2017                  */
/* ===================================== */
Aantal velden=Number of bays
Eenfase=Single phase
Tweefasen=Two phase
Driefasen=Three phase
Afkorting=Abbrevation
Afspanmast=Anchor tower
Aftakmast=Branch tower
anders/onbekend=other/unknown
Asymmetrisch enkelcircuitmast=Single circuit tower
B2B converter=B2B converter
Bedankt voor uw feedback we gaan er zo snel mogelijk mee aan de slag=Thank you for your feedback. We will process it as soon as possible
Dank dat u wil helpen met het verbeteren van onze netkaart, vul alstublieft het formulier in=Thank you for helping us to improve the gridmap. Please complete the form below to submit feedback
Mochten wij naar aanleiding van uw bericht nog vragen hebben, dan nemen we contact met u op=We will contact you, should we have any questions regarding your feedback
Bedr.spanning=Oper. voltage
Bedrijfscentrum=Control center
Bedrijfsmiddel=Component
Bedrijfsspanning=Operating voltage
Beheerder=Grid Operator
Beheerder primair=Primary operator
Beheerder secundair=Secundary operator
Beheerdercode=Operator code
Beheerdernaam=Operator name
Beheerdernummer=Operator number
Benutting=Use
Betonnen mast=Concrete/stobie pole
Bipole=Bipole
Bipoolmast=Bipole tower
Bouwwijze=Construction
Bouwjaar onbekend=Year of construction unknown
Bron(nen)=Source(s)
Buismast=Tubular pole
Bug/Update=Bug/Update
Capaciteit=Capacity
Circuits=Circuits
Code=Code
Colofon=Colophon (nl)
Combinatiemast=Hybrid configured tower
Communicatietoren=Telecontrol tower
Compensatiespoel=Reactor coil
Condensatorbank=Capacitor bank
Condensatorveld=Capacitor bay
Constructiewijze=Construction
Controle getal=Control number
Converter=Converter
Copyrights=Copyrights
Bipool=Bipole
Monopool aardretour=Monopole ground return
Monopool geleiderretour=Monopole metallic return
Symmetrische monopool=Symmetrical monopole
Deelnet=Subgrid
Deltamast=Delta tower
Dennenboommast=Semi-vertical configured tower
Disclaimer=Disclaimer (nl, e)
Donaumast=Donau tower
Driehoeksmast=Single circuit tower
Drierail=Triple busbar
Drievlaksmast=Vertical configured tower 
Dubbelrail=Double busbar
Dubbelrail - U-I=Double busbar - U-I layout
Dubbelrail - bypassrail=Double busbar with bypass
Dubbelvlagmast=Vertical configured tower
Eengeleidermast=Single phase tower
Eindmast=Termination tower
Elektrodepunt=Electrode 
Enkelrail=Single busbar
Enkelrail - langskoppeling=Single busbar with sectioncoupler
Er moet een Gebruikersnaam en Wachtwoord worden ingevuld=Please submit your Username and Password
Er kan op dit moment geen verbinding gemaakt worden met de netkaart-database, probeer het over 20 seconden normaals=At this moment we can not connect to the Gridmap-database, please try again in 20 seconds.
Fase-nul=Phase-Neutral
Feedback netkaart=Feedback Gridmap
Feedback formulier=Feedback form
Feedback geregistreerd op Github=Thank you! Your feedback is registred at Github
Feedback melden=Send feedback
Foto URL=Image URL
FOUT: Geen data gevonden=Error: no data found
FOUT: geen valide input=Error: non-valid input
Fout melden=Report an error
Foute query=Invalid query
Frequentie-omvormer=Frequency converter
Functie=Function
Gaffelmast=Fork tower
Gasgeïsoleerd=Gas insulated
Gebruiker login=User login
Gebruikersnaam=Username
Gebruikersnaam/Wachtwoord ongeldig=Username and/or Password unknown
Gecombineerde situatie=Combined situation
Geen AC of DC=No AC or DC
GEEN FOTO BESCHIKBAAR=NO IMAGE AVAILABLE
Geen correct gegevens type=Invalid input syntax
Geen geldig circuit ID=Not a valid circuit ID
Geen geldige afbeelding URL=Not a valid image URL
Geen integer=Not an integer
Geen jaar tussen 0 en 9999=Not a year between 0 and 9999
Geen wijzigingen=No changes
Geen zoekresultaat=No search result
Gelijkspanning=Direct Current
Generatorveld=Generator bay
GIS=GIS
Grond=Ground
Grondkabel=Underground cable
Hamerkopmast=Horizontal configured tower
Handleiding=Manual (nl)
Hangende rails=Suspended busbars
Harde aftak=Branch (fixed)
heden=today
hier=here
Hoekmast=Anchor tower with line angle
HoogspanningsNet Netkaart=HoogspanningsNet Gridmap
Hoogspanningskabel=Underground cable
Hoogspanningslijn=Overhead line
Hoogspanningsmast=Pylon
Hoogspanningsstation=Substation
Hoogste spanning=Highest voltage
Hoogte=Height
Houten mast=Wood pole
Hybride geïsoleerd=Hybrid insulation
Hybridemast=Hybrid constructed tower
ID=ID
ID niet gevonden=ID not found
In dienst=Active
ingevuld bij=input at
Inloggen=Login
Inloggen om te bewerken=Login to edit
Inlussing=U-branch
Instellingen=Settings
Instellingen opslaan=Save settings
Instellingen opgeslagen=Settings are saved
Instellingen verbergen=Hide settings
Instellingen weergeven=Show settings
item=object
Item bijgewerkt=Object updated
Item niet bijgewerkt, waarden waren niet gewijzigd=Object not updated, values were unchanged
Kabel=Cable
kabel=cable
Kabelveld=Cable bay
Kies=Choose
Klantstation=Client substation
Klik om deze gegevens te bewerken=Click here to edit
Knooppunten=Nodes
Koppelstation=Coupler transformer station
Koppelveld=Bus coupler
Land=Country
Layers opslaan=Save layers
Legenda=Key
Legenda verbergen=Hide key
Legenda weergeven=Show key
Lengte=Length
Lijn=Line
Lijnveld=Line bay
Luchtgeïsoleerd=Air insulated
Luchtlijn=Overhead line
Masten=Pylons
Mastfunctie=Tower function
Masthoogte=Tower height
Mastmodel=Tower layout
Mastnummer=Tower number
Meld een fout of aanvullende informatie over dit object=Report an error or send new information about this object
Model=Model
Monopool aardretour=Monopole ground return
Monopool geleiderretour=Monopole metallic return
Naam=Name
naam=name
Naar mijn huidige locatie!=To my location!
Netfrequentie=Grid frequency
Net knooppunt=Node
Netkaart instellingen=Gridmap Settings
Netsituatie=Grid situation
Objecttype=Object type
onbekend=unknown
Onderwerp=Topic
Ongeldige landcode=Invalid countrycode
Onjuist format=Invalid format
Ontw.spanning=Desn. voltage
Ontwerpspanning=Design voltage
Opmerkingen=Remarks
Opstijgpunt=Cable riser
overig (zie opmerkingen)=other (see remarks)
overig=other
Overig=Other
Overkruisingsmast=Line crossing tower
Over de netkaart=About the Gridmap
Overkruising=Line crossing
Pas uw criteria aan=Please change your query
Portaalmast=H-frame tower
Productie=Generation
Railcapaciteit=Busbar capacity
Railconfiguratie=Busbar configuration
Release notes=Release Notes
Ringrail=Ring busbar
Schakelbare aftak=Branch (switchable)
Schakelstation=Switching substation
Schoormast=Guyed tower
Secundair=Secondary
Spanning=Voltage
Spanningen=Voltages
Spanningsloos=Not used
Splitsing=Split
Splitsingsmast=Split tower
Spoelveld=Reactor bay
Staande rails=Supported busbars
Stationsiconen=Station pictogram
Stationsterreinen=Station area
Steunmast=Suspension tower
Stijgjuk=Anchor portal
Subtype=Sub type
Supergeleidend=Superconducting
Symmetrical monopole=Symmetrical monopole
Systeem=System
Taal voorkeur=Language preferences
Taal=Language
TF-apparatuur=Frequency signal equipment
Tonmast=Barrel
Transformator=Power transformer
Trafostation=Transformer substation
Transformatorveld=Transformer bay
Transportcapaciteit=Circuit capacity
Tweevlaksmast=Double horizontal confugured pylon
Type=Type
U bent binnen=You are in
U kunt de voortgang=You can track the progress of your ticket
Uit dienst=End of service
Uw naam=Name
Uw email=Email
Uw feedback=Your feedback
Vakwerkmast=Lattice tower
van dit punt=from here
Verbinding=Connection
Verbindingen=Connections
Versie=Version
Verzend feedback=Send feedback
Verzenden=Send
Viervlaksmast=Four-levelled horizontal configured tower
View opslaan=Save view
Vlagmast=Single side vertically aligned tower
Volg locatie=Follow my location
volgen=follow
Wachtwoord=Password
Wijzingen=Changes
Wisselmast=Transposition tower
Wisselspanning=Alternating Current
Wissen=Clear
Zee=Sea
Zoek...=Search...
Zoeken!=Search!
Zoeken in de netkaart=Search the Gridmap
Naar de website=To our website
Nederlands=Dutch
Nedersaksisch=Lower Saxony
Deens=Danish
Duits=German
Engels=English
Frans=French
Nederland=Netherlands
België=Belgium
Duitsland=Germany
Franrijk=France
Groot Britannië=United Kingdom
Denemarken=Denmark
Zwitserland=Switzerland
Oostenrijk=Austria
Spanje=Spain
Italië=Italy
Polen=Poland
Zweden=Sweden
Noorwegen=Norway
